######################################################################
#....................................................................#
#....................................................................#
#...........................................###########..............#
#....................................................................#
#....................................................................#
#......................................................##########....#
#..........######....................................................#
#...............#....................................................#
#...............#....................................................#
#...............#....................................................#
#...............#..............................#.....................#
#..............................................#.....................#
#..............................................#.....................#
#..............................................#.....................#
#................#.............................#.....................#
#................#.............................#.....................#
#................#...................................................#
#................#...................................................#
#................#...................................................#
#................#...................................................#
#....................................................................#
#....................................................................#
#....................................................................#
#....................................................................#
#...................................###############..................#
#....................................................................#
#....................................................................#
#.......##########...................................................#
#....................................................................#
#....................................................................#
#....................................................................#
#....................................................................#
######################################################################